111111
1PC0C1
110001
110111
1V01E1
110001
111111