11111111111111111
10C000000000000E1
1P000000000000001
10000000000000001
100000C0000000001
100000CVVV0000001
10000000000000001
11111111111111111